{
    "tileSet": "default",
    "height": 10,
    "width": 10,
    "cells": [
        [0, 1, 2, 3, 0, 1, 2, 3, 0, 1],
        [1, 2, 3, 0, 1, 2, 3, 0, 1, 2],
        [2, 3, 0, 1, 2, 3, 0, 1, 2, 3],
        [3, 0, 1, 2, 3, 0, 1, 2, 3, 0],
        [0, 1, 2, 3, 0, 1, 2, 3, 0, 1],
        [1, 2, 3, 0, 1, 2, 3, 0, 1, 2],
        [2, 3, 0, 1, 2, 3, 0, 1, 2, 3],
        [3, 0, 1, 2, 3, 0, 1, 2, 3, 0],
        [0, 1, 2, 3, 0, 1, 2, 3, 0, 1],
        [1, 2, 3, 0, 1, 2, 3, 0, 1, 2]
    ]
}